11111111111111111111111111
1100000001000C00000C0C0111
1010000001000000C00C0C0111
1C010000011110000000000111
1C000000000000000E00000111
100000000000000000000P0011
10000010000000000000000001
11111111111111111111111111