1111111111111111111111111
1C00000001000000C00C0C011
1C00000001000000C00C0C011
1C00000001111000000000011
1C00000000000000000000011
110011110000000000000P0E1
1111111111111111111111111