11111111111111111111111111
1100000001000C00000C0C0111
1010000001000000C00C0C0111
1C01000001111000000000P111
1C000000000000000000000111
10000000000000001111101111
100000100000000010000E0001
11111111111111111111111111