1111111111
1C000CC011
110011P0E1
1111111111