111111111111111111111
1000P000E00000C000001
111111111111111111111