11111111111111111111
11000000011111000001
10100000000001000C01
1P00000C0000E0000001
11111111111111111111