11111111111111111111
11111111111111111111
11000000011111CCCCC1
10100000000011CCCCC1
1P00000C0000ECCCCCC1
11111111111111111111