11111111
1000P001
10C00E01
11111111