1111111111111
100CP00111111
10000E0111111
1111111111111
1100011110111
1111111111111
1111111111111
