1111111111111
1000P00111111
10C00E01E1111
1111111111111
1100011110111
1111111111111
1111111111111