1111111111
1C100CC011
110E11P111
1111111111